bbbbbbbbbbbbbbbbbbbbbbbbbbbbbbbbbbbbbbbbbbbbbbbbbbbbbbbbbbbbbbbbbbbbbbbbbbbbbbbbbbbbbbbbbbbbbbbbbbbbbbbbbbbbbbbbbbbbbbbbbbbbbbbbbbbbbbbbbbbbbbbbbbbbbbbbbbbbbbbbbbbbbbbbbbbbbbbbbbbbbbbbbbbbbbbbbbbbbbbbbbbbbbbbbbbbbbbbbbbbbbbbbbbbbbbbbbbbbbbbbbbbbbbbbbbbbbbbbbbb#####
#sss################s#################ssssss#####sssssssss###############################################################################################################################################################################################################
#########################################################################################################################################################################################################################################################################
###################################################################################################BE###B##################################################################################################################################################BB############
#####################B#####################################################################BBBBB###BBBBBB######################################BBB##BBBBBBBB##############################################################################################BBB############
#########################################################################################################################################################################################################################################################BBBB############
##################B##E#B###########################BBBB#######BBBB######################################################################################################################################################################################BBBBB############
############B#####BBBBBB############################BB#########BB##########################################################################B####################B###B##############BB###B##############################BBBBBBBBBBBBB###################BBBBBB############
#########################################BBBB#######BB#########BB######################BBB#####################################################################BB###BB############BBB###BB############################################################BBBBBBB############
##P############################BB#########BB########BB###E##E##BB#############################################################################################BBB###BBB##########BBBB###BBB#################BB################################BB#####BBBBBBBB############
###########S#########E#########BB#########BB###E####BB#########BB####################################################EE###########E########E#################BBBB#E#BBBB########BBBBB###BBBB################BB#############E#####E############BB####BBBBBBBBB##########G#                                              
BBBBBBBBBBBBBBBBBBBBBBBBBBBBBBBBBBBBBBBBBBBBBBBBBBBBBBBBBBBBBBBBBBBBBBBBBBBBBBBB##BBBBBBBBBBBBBBB#####BBBBBBBBBBBBBBBBBBBBBBBBBBBBBBBBBBBBBBBBBBBBBBBBBBBBBBBBBBBBBBBBBBBBBBBBBBBBBBB###BBBBBBBBBBBBBBBBBBBBBBBBBBBBBBBBBBBBBBBBBBBBBBBBBBBBBBBBBBBBBBBBBBBBBBBBBBBBBBBBB

